20
....................
.*.****************.
.*.*..............*.
.*.*.************.*.
.*.*.*..........*.*.
.*.*.*.********.*.*.
.*.*.*........*.*.*.
.*.*.*........*.*.*.
.*.*.*........*.*.*.
....................
.*.*.*........*.*.*.
.*.*.*........*.*.*.
.*.*.*........*.*.*.
.*.*.*........*.*.*.
.*.*.**********.*.*.
.*.*............*.*.
.*.**************.*.
.*................*.
.******************.
....................
